{
  "id": "lobby",
  "name": "Lobby Principal",
  "width": 20,
  "height": 15,
  "grid": [
    [0,0,0,0,1,1,1,1,1,1,1,1,1,1,1,1,0,0,0,0],
    [0,0,0,1,1,1,1,1,1,1,1,1,1,1,1,1,1,0,0,0],
    [0,0,1,1,1,1,1,1,1,1,1,1,1,1,1,1,1,1,0,0],
    [0,1,1,1,1,1,1,1,1,1,1,1,1,1,1,1,1,1,1,0],
    [1,1,1,1,1,1,1,1,1,1,1,1,1,1,1,1,1,1,1,1],
    [1,1,1,1,1,1,1,1,1,1,1,1,1,1,1,1,1,1,1,1],
    [1,1,1,1,1,1,1,1,1,1,1,1,1,1,1,1,1,1,1,1],
    [2,1,1,1,1,1,1,1,1,1,1,1,1,1,1,1,1,1,1,1],
    [1,1,1,1,1,1,1,1,1,1,1,1,1,1,1,1,1,1,1,1],
    [1,1,1,1,1,1,1,1,1,1,1,1,1,1,1,1,1,1,1,1],
    [1,1,1,1,1,1,1,1,1,1,1,1,1,1,1,1,1,1,1,1],
    [0,1,1,1,1,1,1,1,1,1,1,1,1,1,1,1,1,1,1,0],
    [0,0,1,1,1,1,1,1,1,1,1,1,1,1,1,1,1,1,0,0],
    [0,0,0,1,1,1,1,1,1,1,1,1,1,1,1,1,1,0,0,0],
    [0,0,0,0,1,1,1,1,1,1,1,1,1,1,1,1,0,0,0,0]
  ],
  "exitZone": {
    "x": 0,
    "y": 7
  },
  "spawnPoints": [
    {"x": 10, "y": 10},
    {"x": 8, "y": 10},
    {"x": 12, "y": 10}
  ]
}